D∆∞·ªõi ƒë√¢y l√† danh s√°ch t·ª´ v·ª±ng ti·∫øng Anh l·ªõp 7 theo c√°c **Unit** trong s√°ch gi√°o khoa ch∆∞∆°ng tr√¨nh **Vi·ªát Nam** (ch∆∞∆°ng tr√¨nh m·ªõi):

---

### **Unit 1: My Hobbies**
- hobby: s·ªü th√≠ch
- gardening: l√†m v∆∞·ªùn
- collecting stamps: s∆∞u t·∫ßm tem
- bird-watching: ng·∫Øm chim
- playing board games: ch∆°i c·ªù b√†n
- arranging flowers: c·∫Øm hoa
- skating: tr∆∞·ª£t patin
- carving: kh·∫Øc
- creative: s√°ng t·∫°o
- unusual: kh√¥ng th√¥ng th∆∞·ªùng

---

### **Unit 2: Health**
- health: s·ª©c kh·ªèe
- calories: calo
- obesity: b√©o ph√¨
- sickness: b·ªánh t·∫≠t
- diet: ch·∫ø ƒë·ªô ƒÉn
- depression: tr·∫ßm c·∫£m
- allergy: d·ªã ·ª©ng
- symptom: tri·ªáu ch·ª©ng
- exercise: t·∫≠p th·ªÉ d·ª•c
- avoid: tr√°nh

---

### **Unit 3: Community Service**
- volunteer: t√¨nh nguy·ªán vi√™n
- community: c·ªông ƒë·ªìng
- benefit: l·ª£i √≠ch
- environment: m√¥i tr∆∞·ªùng
- donate: quy√™n g√≥p
- charity: t·ª´ thi·ªán
- shelter: n∆°i tr√∫ ·∫©n
- disabled people: ng∆∞·ªùi khuy·∫øt t·∫≠t
- elderly people: ng∆∞·ªùi gi√†
- recycle: t√°i ch·∫ø

---

### **Unit 4: Music and Arts**
- artist: ngh·ªá sƒ©
- musician: nh·∫°c sƒ©
- composer: nh√† so·∫°n nh·∫°c
- gallery: ph√≤ng tr∆∞ng b√†y
- opera: nh·∫°c k·ªãch
- instrument: nh·∫°c c·ª•
- perform: bi·ªÉu di·ªÖn
- exhibition: tri·ªÉn l√£m
- folk music: nh·∫°c d√¢n gian
- portrait: ch√¢n dung

---

### **Unit 5: Vietnamese Food and Drink**
- cuisine: ·∫©m th·ª±c
- spring rolls: nem r√°n/ch·∫£ gi√≤
- noodles: m√¨, b√∫n
- pancake: b√°nh k·∫øp
- tofu: ƒë·∫≠u ph·ª•
- soup: s√∫p
- ingredient: nguy√™n li·ªáu
- recipe: c√¥ng th·ª©c
- spicy: cay
- delicious: ngon mi·ªáng

---

### **Unit 6: The First University in Vietnam**
- university: ƒë·∫°i h·ªçc
- temple: ƒë·ªÅn, mi·∫øu
- literature: vƒÉn ch∆∞∆°ng
- heritage: di s·∫£n
- emperor: ho√†ng ƒë·∫ø
- scholar: h·ªçc gi·∫£
- architecture: ki·∫øn tr√∫c
- doctorate: ti·∫øn sƒ©
- preservation: s·ª± b·∫£o t·ªìn
- recognition: s·ª± c√¥ng nh·∫≠n

---

### **Unit 7: Traffic**
- traffic: giao th√¥ng
- vehicle: ph∆∞∆°ng ti·ªán
- zebra crossing: v·∫°ch qua ƒë∆∞·ªùng
- pavement: v·ªâa h√®
- helmet: m≈© b·∫£o hi·ªÉm
- road user: ng∆∞·ªùi tham gia giao th√¥ng
- obey: tu√¢n theo
- accident: tai n·∫°n
- public transport: ph∆∞∆°ng ti·ªán c√¥ng c·ªông
- traffic jam: k·∫πt xe

---

### **Unit 8: Films**
- film: phim
- comedy: phim h√†i
- action film: phim h√†nh ƒë·ªông
- documentary: phim t√†i li·ªáu
- horror film: phim kinh d·ªã
- science fiction: khoa h·ªçc vi·ªÖn t∆∞·ªüng
- director: ƒë·∫°o di·ªÖn
- actor: di·ªÖn vi√™n nam
- actress: di·ªÖn vi√™n n·ªØ
- review: b√†i ƒë√°nh gi√°

---

### **Unit 9: Festivals Around the World**
- festival: l·ªÖ h·ªôi
- parade: cu·ªôc di·ªÖu h√†nh
- celebrate: t·ªï ch·ª©c l·ªÖ k·ª∑ ni·ªám
- fireworks: ph√°o hoa
- carnival: l·ªÖ h·ªôi h√≥a trang
- tradition: truy·ªÅn th·ªëng
- thanksgiving: l·ªÖ t·∫° ∆°n
- religious: thu·ªôc v·ªÅ t√¥n gi√°o
- cultural: thu·ªôc v·ªÅ vƒÉn h√≥a
- costume: trang ph·ª•c

---

### **Unit 10: Sources of Energy**
- energy: nƒÉng l∆∞·ª£ng
- solar power: nƒÉng l∆∞·ª£ng m·∫∑t tr·ªùi
- wind power: nƒÉng l∆∞·ª£ng gi√≥
- fossil fuel: nhi√™n li·ªáu h√≥a th·∫°ch
- electricity: ƒëi·ªán
- renewable: t√°i t·∫°o ƒë∆∞·ª£c
- non-renewable: kh√¥ng t√°i t·∫°o ƒë∆∞·ª£c
- conserve: b·∫£o t·ªìn
- alternative: thay th·∫ø
- pollution: s·ª± √¥ nhi·ªÖm

---

### **Unit 11: Travelling in the Future**
- spaceship: t√†u v≈© tr·ª•
- driverless car: xe kh√¥ng ng∆∞·ªùi l√°i
- solar-powered: ch·∫°y b·∫±ng nƒÉng l∆∞·ª£ng m·∫∑t tr·ªùi
- high-speed train: t√†u cao t·ªëc
- teleportation: d·ªãch chuy·ªÉn t·ª©c th·ªùi
- environmentally friendly: th√¢n thi·ªán v·ªõi m√¥i tr∆∞·ªùng
- modern: hi·ªán ƒë·∫°i
- convenient: ti·ªán l·ª£i
- underwater: d∆∞·ªõi n∆∞·ªõc
- airship: kh√≠ c·∫ßu

---

### **Unit 12: An Overcrowded World**
- overcrowded: ƒë√¥ng ƒë√∫c
- population: d√¢n s·ªë
- urban: ƒë√¥ th·ªã
- rural: n√¥ng th√¥n
- migration: s·ª± di c∆∞
- poverty: ngh√®o ƒë√≥i
- slum: khu ·ªï chu·ªôt
- disease: b·ªánh t·∫≠t
- overpopulation: b√πng n·ªï d√¢n s·ªë
- solution: gi·∫£i ph√°p

---

Hy v·ªçng danh s√°ch n√†y s·∫Ω gi√∫p b·∫°n h·ªçc t·ª´ v·ª±ng hi·ªáu qu·∫£! üòä