D∆∞·ªõi ƒë√¢y l√† danh s√°ch t·ª´ v·ª±ng ti·∫øng Anh l·ªõp 8 theo c√°c **Unit** trong s√°ch gi√°o khoa ch∆∞∆°ng tr√¨nh **Vi·ªát Nam** (ch∆∞∆°ng tr√¨nh m·ªõi):  

---

### **Unit 1: Leisure Activities**
- leisure: th·ªùi gian r·∫£nh
- craft kit: b·ªô d·ª•ng c·ª• th·ªß c√¥ng
- DIY (do it yourself): t·ª± l√†m
- socialising: giao ti·∫øp x√£ h·ªôi
- window shopping: ng·∫Øm ƒë·ªì (kh√¥ng mua)
- addicted: nghi·ªán
- virtual: ·∫£o
- relaxed: th∆∞ gi√£n
- communicate: giao ti·∫øp
- hang out: ƒëi ch∆°i

---

### **Unit 2: Life in the Countryside**
- countryside: n√¥ng th√¥n
- harvest: thu ho·∫°ch
- herd: chƒÉn (gia s√∫c)
- nomadic: du m·ª•c
- vast: r·ªông l·ªõn
- buffalo-drawn cart: xe k√©o tr√¢u
- inconvenient: b·∫•t ti·ªán
- rural: thu·ªôc n√¥ng th√¥n
- paddy field: ru·ªông l√∫a
- generous: h√†o ph√≥ng

---

### **Unit 3: Peoples of Vietnam**
- ethnic group: d√¢n t·ªôc
- costume: trang ph·ª•c
- heritage: di s·∫£n
- tradition: truy·ªÅn th·ªëng
- minority: thi·ªÉu s·ªë
- custom: phong t·ª•c
- festival: l·ªÖ h·ªôi
- diverse: ƒëa d·∫°ng
- region: khu v·ª±c
- unique: ƒë·ªôc ƒë√°o

---

### **Unit 4: Our Customs and Traditions**
- custom: phong t·ª•c
- tradition: truy·ªÅn th·ªëng
- worship: th·ªù c√∫ng
- ceremony: nghi l·ªÖ
- ancestor: t·ªï ti√™n
- ritual: nghi th·ª©c
- generation: th·∫ø h·ªá
- respect: s·ª± k√≠nh tr·ªçng
- heritage: di s·∫£n
- belief: ni·ªÅm tin

---

### **Unit 5: Festivals in Vietnam**
- festival: l·ªÖ h·ªôi
- celebrate: t·ªï ch·ª©c l·ªÖ k·ª∑ ni·ªám
- ritual: nghi l·ªÖ
- parade: cu·ªôc di·ªÖu h√†nh
- incense: h∆∞∆°ng
- lantern: ƒë√®n l·ªìng
- carnival: l·ªÖ h·ªôi h√≥a trang
- offering: l·ªÖ v·∫≠t
- perform: bi·ªÉu di·ªÖn
- cultural: thu·ªôc vƒÉn h√≥a

---

### **Unit 6: Folk Tales**
- folk tale: truy·ªán d√¢n gian
- fairy tale: truy·ªán c·ªï t√≠ch
- fable: truy·ªán ng·ª• ng√¥n
- legend: truy·ªÅn thuy·∫øt
- moral: b√†i h·ªçc ƒë·∫°o ƒë·ª©c
- cunning: x·∫£o quy·ªát
- brave: d≈©ng c·∫£m
- wisdom: tr√≠ tu·ªá
- witch: ph√π th·ªßy
- ogre: y√™u tinh

---

### **Unit 7: Pollution**
- pollution: s·ª± √¥ nhi·ªÖm
- environment: m√¥i tr∆∞·ªùng
- contaminated: b·ªã √¥ nhi·ªÖm
- dump: v·ª©t b·ªè
- sewage: n∆∞·ªõc th·∫£i
- deforestation: n·∫°n ph√° r·ª´ng
- emission: kh√≠ th·∫£i
- solution: gi·∫£i ph√°p
- poison: ch·∫•t ƒë·ªôc
- hazardous: nguy hi·ªÉm

---

### **Unit 8: English Speaking Countries**
- accent: gi·ªçng n√≥i
- native speaker: ng∆∞·ªùi b·∫£n ng·ªØ
- official language: ng√¥n ng·ªØ ch√≠nh th·ª©c
- symbol: bi·ªÉu t∆∞·ª£ng
- landmark: danh th·∫Øng
- multicultural: ƒëa vƒÉn h√≥a
- diverse: ƒëa d·∫°ng
- territory: l√£nh th·ªï
- iconic: mang t√≠nh bi·ªÉu t∆∞·ª£ng
- breathtaking: ngo·∫°n m·ª•c

---

### **Unit 9: Natural Disasters**
- earthquake: ƒë·ªông ƒë·∫•t
- tsunami: s√≥ng th·∫ßn
- volcano: n√∫i l·ª≠a
- tornado: l·ªëc xo√°y
- flood: l≈© l·ª•t
- drought: h·∫°n h√°n
- landslide: l·ªü ƒë·∫•t
- disaster: th·∫£m h·ªça
- evacuate: s∆° t√°n
- rescue: c·ª©u h·ªô

---

### **Unit 10: Communication**
- communication: giao ti·∫øp
- social media: m·∫°ng x√£ h·ªôi
- technology: c√¥ng ngh·ªá
- verbal: b·∫±ng l·ªùi n√≥i
- non-verbal: kh√¥ng b·∫±ng l·ªùi n√≥i
- interact: t∆∞∆°ng t√°c
- message: tin nh·∫Øn
- website: trang web
- face-to-face: tr·ª±c ti·∫øp
- instant: t·ª©c th√¨

---

### **Unit 11: Science and Technology**
- invention: ph√°t minh
- experiment: th√≠ nghi·ªám
- researcher: nh√† nghi√™n c·ª©u
- laboratory: ph√≤ng th√≠ nghi·ªám
- equipment: thi·∫øt b·ªã
- artificial intelligence: tr√≠ tu·ªá nh√¢n t·∫°o
- innovation: s·ª± ƒë·ªïi m·ªõi
- breakthrough: b∆∞·ªõc ƒë·ªôt ph√°
- application: ·ª©ng d·ª•ng
- astronaut: phi h√†nh gia

---

### **Unit 12: Life on Other Planets**
- planet: h√†nh tinh
- alien: ng∆∞·ªùi ngo√†i h√†nh tinh
- UFO: v·∫≠t th·ªÉ bay kh√¥ng x√°c ƒë·ªãnh
- galaxy: thi√™n h√†
- astronaut: phi h√†nh gia
- spacecraft: t√†u v≈© tr·ª•
- solar system: h·ªá m·∫∑t tr·ªùi
- universe: v≈© tr·ª•
- atmosphere: b·∫ßu kh√≠ quy·ªÉn
- space exploration: th√°m hi·ªÉm kh√¥ng gian

---

Hy v·ªçng danh s√°ch t·ª´ v·ª±ng n√†y gi√∫p b·∫°n h·ªçc t·∫≠p hi·ªáu qu·∫£! üòä