DÆ°á»›i Ä‘Ã¢y lÃ  danh sÃ¡ch tá»« vá»±ng tiáº¿ng Anh lá»›p 9 theo cÃ¡c **Unit** trong sÃ¡ch giÃ¡o khoa chÆ°Æ¡ng trÃ¬nh **Viá»‡t Nam** (chÆ°Æ¡ng trÃ¬nh má»›i):

---

### **Unit 1: A Visit from a Pen Pal**
- pen pal: báº¡n qua thÆ°
- visit: thÄƒm
- tour guide: hÆ°á»›ng dáº«n viÃªn du lá»‹ch
- customs: phong tá»¥c
- tradition: truyá»n thá»‘ng
- souvenir: quÃ  lÆ°u niá»‡m
- folk dance: Ä‘iá»‡u mÃºa dÃ¢n gian
- attraction: Ä‘iá»ƒm tham quan
- itinerary: lá»‹ch trÃ¬nh
- exchange: trao Ä‘á»•i

---

### **Unit 2: City Life**
- city: thÃ nh phá»‘
- crowded: Ä‘Ã´ng Ä‘Ãºc
- skyscraper: tÃ²a nhÃ  chá»c trá»i
- transportation: phÆ°Æ¡ng tiá»‡n giao thÃ´ng
- underground: tÃ u Ä‘iá»‡n ngáº§m
- urban: Ä‘Ã´ thá»‹
- suburb: ngoáº¡i Ã´
- traffic jam: táº¯c Ä‘Æ°á»ng
- pedestrian: ngÆ°á»i Ä‘i bá»™
- public transport: phÆ°Æ¡ng tiá»‡n cÃ´ng cá»™ng

---

### **Unit 3: A Party**
- party: bá»¯a tiá»‡c
- invitation: lá»i má»i
- celebration: lá»… ká»· niá»‡m
- guest: khÃ¡ch má»i
- host: chá»§ nhÃ 
- surprise: sá»± ngáº¡c nhiÃªn
- gift: mÃ³n quÃ 
- occasion: dá»‹p
- decoration: trang trÃ­
- dance: nháº£y mÃºa

---

### **Unit 4: Our Past**
- past: quÃ¡ khá»©
- memory: kÃ½ á»©c
- history: lá»‹ch sá»­
- ancient: cá»• Ä‘áº¡i
- civilization: ná»n vÄƒn minh
- event: sá»± kiá»‡n
- relic: di tÃ­ch
- tradition: truyá»n thá»‘ng
- folklore: vÄƒn hÃ³a dÃ¢n gian
- discovery: khÃ¡m phÃ¡

---

### **Unit 5: The Media**
- media: phÆ°Æ¡ng tiá»‡n truyá»n thÃ´ng
- newspaper: bÃ¡o
- television: truyá»n hÃ¬nh
- radio: Ä‘Ã i phÃ¡t thanh
- internet: internet
- advertisement: quáº£ng cÃ¡o
- program: chÆ°Æ¡ng trÃ¬nh
- journalist: nhÃ  bÃ¡o
- article: bÃ i bÃ¡o
- broadcast: phÃ¡t sÃ³ng

---

### **Unit 6: The Environment**
- environment: mÃ´i trÆ°á»ng
- pollution: Ã´ nhiá»…m
- recycle: tÃ¡i cháº¿
- waste: rÃ¡c tháº£i
- habitat: mÃ´i trÆ°á»ng sá»‘ng
- natural resources: tÃ i nguyÃªn thiÃªn nhiÃªn
- climate change: biáº¿n Ä‘á»•i khÃ­ háº­u
- conservation: báº£o tá»“n
- endangered species: loÃ i nguy cáº¥p
- deforestation: phÃ¡ rá»«ng

---

### **Unit 7: Further Education**
- education: giÃ¡o dá»¥c
- university: Ä‘áº¡i há»c
- college: cao Ä‘áº³ng
- scholarship: há»c bá»•ng
- major: ngÃ nh há»c
- degree: báº±ng cáº¥p
- career: sá»± nghiá»‡p
- study abroad: du há»c
- research: nghiÃªn cá»©u
- faculty: khoa (trong trÆ°á»ng Ä‘áº¡i há»c)

---

### **Unit 8: Future Jobs**
- job: cÃ´ng viá»‡c
- career: nghá» nghiá»‡p
- employer: ngÆ°á»i sá»­ dá»¥ng lao Ä‘á»™ng
- employee: nhÃ¢n viÃªn
- qualification: trÃ¬nh Ä‘á»™ chuyÃªn mÃ´n
- interview: phá»ng váº¥n
- salary: lÆ°Æ¡ng
- promotion: thÄƒng chá»©c
- internship: thá»±c táº­p
- skill: ká»¹ nÄƒng

---

### **Unit 9: Describing the Future**
- future: tÆ°Æ¡ng lai
- prediction: dá»± Ä‘oÃ¡n
- technology: cÃ´ng nghá»‡
- artificial intelligence: trÃ­ tuá»‡ nhÃ¢n táº¡o
- robot: rÃ´-bá»‘t
- climate change: biáº¿n Ä‘á»•i khÃ­ háº­u
- space exploration: thÃ¡m hiá»ƒm khÃ´ng gian
- development: phÃ¡t triá»ƒn
- innovation: Ä‘á»•i má»›i
- possibility: kháº£ nÄƒng

---

### **Unit 10: Conservation**
- conservation: báº£o tá»“n
- environment: mÃ´i trÆ°á»ng
- biodiversity: sá»± Ä‘a dáº¡ng sinh há»c
- endangered: nguy cáº¥p
- protection: báº£o vá»‡
- natural habitat: mÃ´i trÆ°á»ng sá»‘ng tá»± nhiÃªn
- awareness: nháº­n thá»©c
- sustainable: bá»n vá»¯ng
- renewable energy: nÄƒng lÆ°á»£ng tÃ¡i táº¡o
- waste management: quáº£n lÃ½ cháº¥t tháº£i

---

### **Unit 11: National Parks**
- national park: vÆ°á»n quá»‘c gia
- wildlife: Ä‘á»™ng váº­t hoang dÃ£
- species: loÃ i
- conservation: báº£o tá»“n
- reserve: khu báº£o tá»“n
- ecosystem: há»‡ sinh thÃ¡i
- biodiversity: sá»± Ä‘a dáº¡ng sinh há»c
- endangered species: loÃ i nguy cáº¥p
- habitat: mÃ´i trÆ°á»ng sá»‘ng
- preservation: sá»± báº£o tá»“n

---

### **Unit 12: The Asian Games**
- competition: cuá»™c thi
- athlete: váº­n Ä‘á»™ng viÃªn
- medal: huy chÆ°Æ¡ng
- record: ká»· lá»¥c
- match: tráº­n Ä‘áº¥u
- tournament: giáº£i Ä‘áº¥u
- stadium: sÃ¢n váº­n Ä‘á»™ng
- team: Ä‘á»™i
- victory: chiáº¿n tháº¯ng
- fan: ngÆ°á»i hÃ¢m má»™

---

Hy vá»ng danh sÃ¡ch tá»« vá»±ng nÃ y giÃºp báº¡n há»c táº­p hiá»‡u quáº£ vÃ  Ã´n táº­p tá»‘t cho ká»³ thi! ğŸ˜Š